
#################################################
#			                        			#
#						                        #						
#						                        #
#						                        #
#						                        #
#						                        #
#						                        #
#						                        #
#						                        #
#						                        #
#						                        #									
#						                        #
#						                        #
#						                        #
#						                        #
#						                        #
#################################################						
