
#################################################
#			              		#
#			                        #						
#			                        #
#						#
#			                        #
#			                        #
#				                #
#			                        #
#			                        #
#			                        #
#			                        #									
#			                        #
#			                        #
#			                        #
#			                        #
#			                        #
#################################################						
