#################################################
#			              		                #
#			                                    #
#			                                    #
#						                        #
#			                                    #
#			                                    #
#				                                #
#			                                    #
#			                                    #
#			                                    #
#			                                    #
#			                                    #
#			                                    #
#			                                    #
#			                                    #
#			                                    #
#################################################
