################
#         #    #
#       ###    #
#       #      #
#            ###
#       #      #
#       #      #
#   #      #   #
################