
#################################################
#			                                          #
#						                                    #
#						                                    #
#						                                    #
#						                                    #
#						                                    #
#					                                      #
#					                                      #
#					                                      #
#					                                      #
#					                                      #
#					                                      #
#					                                      #
#					                                      #
#					                                      #
#					                                      #
#################################################
